NewLabel0=Label files created on 11/22/2020 08:01:46 for label file Id OneMoreActionQueueFramework and language en-US
 ;Label file comment - see above label
OneMoreActionQueueMessage=Message
OneMoreActionQueueTypeId=Action type Id
OneMoreActionQueueActionId=Action Id
OneMoreActionQueue=Action queue
OneMoreActionQueueMainMenu=OneMore action queue
OneMoreActionQueueActionCantBeAddedToQueue=Action '%1' can't be added to the queue
OneMoreActionQueueView=View OneMore action queue
OneMoreActionQueueMaintain=Maintain OneMore action queue
OneMoreActionQueueEntityView=View 'OneMore action queue entity'
OneMoreActionQueueEntityMaintain=Maintain 'OneMore action queue entity'
OneMoreActionQueueTypeDoesNotExist=Action queue type '%1' does not exist
OneMoreActionQueueType=Action queue type
OneMoreActionQueueProcessingPrefix=Action '%1'
OneMoreActionQueueProcess=Process
OneMoreActionQueueMessageExample=Message example
OneMoreActionQueueUnknownError=Unknown error
OneMoreActionQueueFieldIsNotSpecified=Field '%1' is not specified in action message
OneMoreActionQueueProcessorValidationError=Business action processor validation error
OneMoreActionQueueActionTypeIsNotEnabled=Action queue type '%1' is not enabled
OneMoreActionQueueProcessingTypeSync=Synchronous
OneMoreActionQueueProcessingType=Processing type
OneMoreActionQueueResponseType=Response type
OneMoreActionQueueRunAction=Run action '%1'
OneMoreActionQueueTypeCustom=Custom action
OneMoreActionQueueTypeMenuItem=Menu item
OneMoreActionQueueMenuItemParameter=Action queue menu item parameter
OneMoreActionQueueMenuItemParameters=Set menu item parameters
OneMoreActionQueueParameterNotFoundInContract=Parameter '%1' was not found in contract
OneMoreActionQueueRetryAttemptNumber=Number of retry attempts 
OneMoreActionQueueRetryAttemptInterval=Retry attempt interval
OneMoreActionQueueRetryAttemptIntervalHelpText=Retry attempt interval (in seconds)
OneMoreActionQueueMenuItemName=Menu item name
OneMoreActionQueueMenuItemPackedParameters=Menu item packed parameters
OneMoreActionQueueStatusWaiting=Waiting
OneMoreActionQueueStatusProcessed=Processed
OneMoreActionQueueStatusError=Error
OneMoreActionQueueProcessingNotes=Processing notes
OneMoreActionQueueEntity=OneMore action queue entity
OneMoreActionQueueBatchBundling=Batch bundling
OneMoreActionQueueEnableBatchBundling=Enable batch bundling
OneMoreActionQueueBatchBundleSize=Batch bundle size
OneMoreActionQueueRecordShouldBeInStatus=Action queue record should be in status '%1'
OneMoreActionQueueRecordIsInProcessOrDoesNotExist=Action queue record is already in process or does not exist
OneMoreActionQueueLogTable=Action queue log
OneMoreActionQueueNoInfologFound=No infolog found
OneMoreActionQueueLogView=View OneMore action queue log
OneMoreActionQueueInquire=Inquire into OneMore action queue
OneMoreActionQueueViewer=OneMore action queue viewer
OneMoreActionQueueAdministrator=OneMore action queue administrator
OneMoreActionQueueBusinessEventsEndpoint=OneMore action queue
OneMoreActionQueueBusinessEventsEndpointTable=OneMore action queue business events endpoint
OneMoreActionQueueBusinessEventsEndpointFields=OneMore action queue business events endpoint fields
OneMoreActionQueueShowLog=Show log
OneMoreActionQueueCantUnpackMenuItemParameters=Error occured during menu item parameters unpack operation
OneMoreActionQueueClassIsNotSupported=Class name '%1' is not supported
OneMoreActionQueueActionMenuWasNotFound=Action menu '%1' was not found
OneMoreActionQueueTransformationJSON=Transformation JSON
OneMoreActionQueueTypeTransformation=OneMore action queue type transformation
OneMoreActionQueueRetryParameters=Retry parameters
OneMoreActionQueueTransformedMessage=Transformed message
OneMoreActionQueueEitherMenuItemOrClassNameSelected=Either menu item or class name should be selected
OneMoreActionQueueMenuItemParametersAreNotSpecified=Menu item parameters are not specified
OneMoreActionQueueReliableAsyncBatchGroupId=Batch group id
OneMoreActionQueueRunAsUserId=Run as
OneMoreActionQueueReliableAsync=Reliable asynchronous
OneMoreActionQueueLogExceptionTypeName=Exception type
OneMoreActionQueueCreatedModified=Created/Modified
OneMoreActionQueueCleanUp=Clean-up action queue
OneMoreActionQueueCleanUpTmp=Clean-up temp action queue
OneMoreActionQueueNumberOfDeletedRecord=%1 records deleted
OneMoreActionQueueProcessing=OneMore action queue processing
OneMoreActionQueueProcessingTypeProcessAutomation=Process automation
OneMoreActionQueueProcessingProcessAutomationTaskCaption=The backgroung processing task used to process '%1' action queue messages in batch
OneMoreActionQueueProcessAutomationPollingInterval=Polling interval
OneMoreActionQueueProcessingHasBeenCompleted=OneMore action queue processing for '%1' has been completed
OneMoreActionQueueProcessingTypeBatchJob=Batch job
OneMoreActionQueueProcessBatchJob=Process action queue (batch job)
OneMoreActionQueueChangeStatus=Change status
OneMoreActionQueueBusinessEventTypeDescription=Business events for the %1 OneMore action queue type. Use these events to respond to OneMore action queue processing events (processed or error)
